ABBBBBBBBBBBBBBBBBD
R                 R
R               1 R
I           EQQQQQH
I  0              R
IQQQL             R
R                 R
R                 R
I                 H
N                 N