STTTTTTTTTTTSSSSSSS
S 0         S     I
SBBBBBBBD         I
S       MOOOQQQL  I
S                 I
S 1 AQQQQQQQQQL   I
SSSSS             I
S       EQOOOOQQQQS
S                 S
S                 S