XXXXXXXXXXXXXVVVVVX
X 0         X     X
XXXXXXXXX         X
X       XVVVXXXX  X
V                 X
X E XXXXXXXXXXX   X
XXXXX             X
X       XXVVVVXXXXX
X                 X
X                 X