AQQQQQQQQQQQBQBBBQD
R 0         N     R
IQQQQQQQD         R
I       I      C  R
I       MQQQQQQP  R
R 1               R
IQQQL             R
R       EQQOOOQQQQH
R                 R
N                 N