SSSSSSSSSSSSSSSSSSS
S                 S
S               1 S
S           EQQQQQS
S  0              S
SQQQL             S
S                 S
S                 S
S                 S
S                 S