XXXXXXXXXXXXXVVVVVX
X 0         X     X
XXXXXXXXX         X
V       V      X  X
V       XXXXXXXX  X
X E               X
XXXXX             X
X       XXVVVVXXXXX
X                 X
X                 X