XXXXXXXXXXXXXXXXXXX
X                 X
X               E X
X           XXXXXXX
X  0              X
XXXXX             X
X                 X
X                 X
X                 X
XXXXXXXXXXXXXXXXXXX