XXXXXXXXXXXXXXXXXXX
X                 X
X               E X
X           XXXXXXX
X                 X
X                 X
X                 X
X                 X
X 0               X
XXXXXXXXXXXXXXXXXXX