AQQQQQQQQQQQQQQQQQD
R 0               H
IQQQQQQD      X   R
R      MD     X   R
R       ISH XXX   R
R       MOP XXXX  R
I                 R
R 1          X    R
IQQQL        V    R
N            XXXL N