STTTTTTTTTTTSSSSSSS
S 0         S     I
SBBBBBBBD         I
S       R      C  I
S       MOOOOOOP  I
S 1               I
SQQQL             I
S       EQOOOOOOOOS
S                 S
S                 S