AQQQQQQQQQQQQBBBBBD
R 0         N     R
IQQQQQQQD         R
R       MBBBQQQL  R
I                 R
R 1 AQQQQQQQQQL   R
IQQQP             R
R       EQOOOOQQQQH
R                 R
N                 N