XVVVVVVVVVVVVVVVVVX
X                 X
X               E X
V           XXXXXXX
V  0              X
XXXXX             X
X                 X
X                 X
V                 V
X                 X