SOOOOOOOOOOOOOOOOOS
H 0               S
SBBBBBBD      S   I
S      SD     S   I
S       SSS SSS   I
S       OOO OOOL  I
S                 I
S 1          S    I
SQQQL        S    I
S            SBBD I